{
  "maps": [
    {
      "id": "depot_alpha",
      "name": "Supply Depot Alpha",
      "width": 20,
      "height": 15,
      "playerStart": { "x": 128, "y": 128 },
      "grid": [
        [2,2,2,2,2,2,2,2,2,2,2,2,2,2,2,2,2,2,2,2],
        [2,1,1,1,1,1,1,1,1,1,1,1,1,1,1,1,1,1,1,2],
        [2,1,1,1,1,1,1,1,1,1,1,1,1,1,1,1,1,1,1,2],
        [2,1,1,1,1,1,1,1,1,1,1,1,1,1,1,1,1,1,1,2],
        [2,1,1,1,2,2,1,1,1,1,1,1,1,1,1,1,1,1,1,2],
        [2,1,1,1,2,1,1,1,1,1,1,1,1,1,1,1,1,1,1,2],
        [2,1,1,1,1,1,1,1,1,1,1,1,1,1,1,1,1,1,1,2],
        [2,1,1,1,1,1,1,1,3,3,1,1,1,1,1,1,1,1,1,2],
        [2,1,1,1,1,1,1,1,3,3,1,1,1,1,1,1,1,1,1,2],
        [2,1,1,1,1,1,1,1,1,1,1,1,1,1,1,1,1,1,1,2],
        [2,1,1,1,1,1,1,1,1,1,1,1,1,1,2,2,1,1,1,2],
        [2,1,1,1,1,1,1,1,1,1,1,1,1,1,2,1,1,1,1,2],
        [2,1,1,1,1,1,1,1,1,1,1,1,1,1,1,1,1,1,1,2],
        [2,1,1,1,1,1,1,1,1,1,1,1,1,1,1,1,1,1,1,2],
        [2,2,2,2,2,2,2,2,2,2,2,2,2,2,2,2,2,2,2,2]
      ],
      "entities": [
        { "type": "terminal", "x": 520, "y": 264, "challengeId": "challenge_1" },
        { "type": "terminal", "x": 776, "y": 392, "challengeId": "challenge_2" },
        { "type": "terminal", "x": 264, "y": 648, "challengeId": "challenge_3" },
        { "type": "portal", "x": 1152, "y": 128, "targetMapId": "data_core" }
      ]
    },
    {
      "id": "data_core",
      "name": "Sector 2: The Data Core",
      "width": 25,
      "height": 20,
      "playerStart": { "x": 128, "y": 600 },
      "grid": [
        [2,2,2,2,2,2,2,2,2,2,2,2,2,2,2,2,2,2,2,2,2,2,2,2,2],
        [2,1,1,1,1,1,1,1,1,1,2,2,2,1,1,1,1,1,1,1,1,1,1,1,2],
        [2,1,1,1,1,1,1,1,1,1,2,2,2,1,1,1,1,1,1,1,1,1,1,1,2],
        [2,1,1,2,2,2,1,1,1,1,1,1,1,1,1,1,1,2,2,2,1,1,1,1,2],
        [2,1,1,2,2,2,1,1,1,1,1,1,1,1,1,1,1,2,2,2,1,1,1,1,2],
        [2,1,1,1,1,1,1,1,1,1,1,1,1,1,1,1,1,1,1,1,1,1,1,1,2],
        [2,1,1,1,1,1,1,3,3,3,3,3,3,3,3,3,1,1,1,1,1,1,1,1,2],
        [2,1,1,1,1,1,1,3,3,3,3,3,3,3,3,3,1,1,1,1,1,1,1,1,2],
        [2,1,1,2,2,2,1,1,1,1,1,1,1,1,1,1,1,1,1,1,2,2,2,1,2],
        [2,1,1,2,2,2,1,1,1,1,1,1,1,1,1,1,1,1,1,1,2,2,2,1,2],
        [2,1,1,1,1,1,1,1,1,1,1,1,1,1,1,1,1,1,1,1,1,1,1,1,2],
        [2,1,1,1,1,1,1,1,1,1,2,2,2,1,1,1,1,1,1,1,1,1,1,1,2],
        [2,1,1,1,1,1,1,1,1,1,2,2,2,1,1,1,1,1,1,1,1,1,1,1,2],
        [2,1,1,2,2,2,1,1,1,1,1,1,1,1,1,1,1,1,1,1,2,2,2,1,2],
        [2,1,1,2,2,2,1,1,1,1,1,1,1,1,1,1,1,1,1,1,2,2,2,1,2],
        [2,1,1,1,1,1,1,3,3,3,3,3,3,3,3,3,1,1,1,1,1,1,1,1,2],
        [2,1,1,1,1,1,1,1,1,1,1,1,1,1,1,1,1,1,1,1,1,1,1,1,2],
        [2,1,1,1,1,1,1,1,1,1,1,1,1,1,1,1,1,1,1,1,1,1,1,1,2],
        [2,1,1,1,1,1,1,1,1,1,1,1,1,1,1,1,1,1,1,1,1,1,1,1,2],
        [2,2,2,2,2,2,2,2,2,2,2,2,2,2,2,2,2,2,2,2,2,2,2,2,2]
      ],
      "entities": [
        { "type": "terminal", "x": 320, "y": 320, "challengeId": "challenge_4" },
        { "type": "terminal", "x": 1280, "y": 320, "challengeId": "challenge_5" },
        { "type": "terminal", "x": 800, "y": 1000, "challengeId": "challenge_6" }
      ]
    }
  ]
}
